XXXXXXXXXXX
X>........X
X.X.XXXXX.X
X.X.....X.X
X.X.XXXXXXX
X.XPX.....X
X.XXX.XXX.X
X.X...X...X
X.X.XXXXX.X
X.......X..
XXXXXXXXXXX